11111111111111111111111
1PIIIIIIIIIIIIIIIIIIII1
1CCCCCCCCCCCCCCCCCCCCC1
1IIIIIIIIIIIIIIIIIIIIC1
1CCCCCCCCCCCCCCCCCCCCC1
1CIIIIIIIIIIIIIIIIIIII1
1CCCCCCCCCCCCCCCCCCCCE1
11111111111111111111111
