1111111111111
10P10000000C1
1000011111001
1P0011E000011
1111111111111