111111111
100C00001
1P00010E1
100000001
111111111
