1111111111111
100100000I0C1
10C0011111001
1P0011E000001
1111111111111
