11111111111111111111111
1PCCCCCCCCCCCCCCCCCCCC1
1CCCCCCCCCCCCCCCCCCCCC1
1CCCCCCCCCCCCCCCCCCCCC1
1CCCCCCCCCCCCCCCCCCCCC1
1CCCCCCCCCCCCCCCCCCCCE1
11111111111111111111111
